month,year,disease,counts,cumulative sum,monthyear,yearquarter,bianual
10,2006,CKD,2,2,2006-10-01,2006 Q3,2006-2007
11,2006,CKD,1,3,2006-11-01,2006 Q3,2006-2007
04,2007,CKD,1,4,2007-04-01,2007 Q1,2006-2007
05,2007,CKD,1,5,2007-05-01,2007 Q2,2006-2007
06,2007,CKD,1,6,2007-06-01,2007 Q2,2006-2007
08,2007,CKD,1,7,2007-08-01,2007 Q2,2006-2007
10,2007,CKD,2,9,2007-10-01,2007 Q3,2006-2007
01,2008,CKD,1,10,2008-01-01,2008 Q1,2008-2009
02,2008,CKD,2,12,2008-02-01,2008 Q1,2008-2009
03,2008,CKD,1,13,2008-03-01,2008 Q1,2008-2009
04,2008,CKD,2,15,2008-04-01,2008 Q1,2008-2009
06,2008,CKD,1,16,2008-06-01,2008 Q2,2008-2009
08,2008,CKD,1,17,2008-08-01,2008 Q2,2008-2009
09,2008,CKD,3,20,2008-09-01,2008 Q3,2008-2009
11,2008,CKD,6,26,2008-11-01,2008 Q3,2008-2009
12,2008,CKD,7,33,2008-12-01,2008 Q3,2008-2009
01,2009,CKD,658,691,2009-01-01,2009 Q1,2008-2009
02,2009,CKD,663,1354,2009-02-01,2009 Q1,2008-2009
03,2009,CKD,743,2097,2009-03-01,2009 Q1,2008-2009
04,2009,CKD,739,2836,2009-04-01,2009 Q1,2008-2009
05,2009,CKD,772,3608,2009-05-01,2009 Q2,2008-2009
06,2009,CKD,770,4378,2009-06-01,2009 Q2,2008-2009
07,2009,CKD,820,5198,2009-07-01,2009 Q2,2008-2009
08,2009,CKD,836,6034,2009-08-01,2009 Q2,2008-2009
09,2009,CKD,787,6821,2009-09-01,2009 Q3,2008-2009
10,2009,CKD,852,7673,2009-10-01,2009 Q3,2008-2009
11,2009,CKD,837,8510,2009-11-01,2009 Q3,2008-2009
12,2009,CKD,854,9364,2009-12-01,2009 Q3,2008-2009
01,2010,CKD,196,9560,2010-01-01,2010 Q1,2010-2011
02,2010,CKD,142,9702,2010-02-01,2010 Q1,2010-2011
03,2010,CKD,145,9847,2010-03-01,2010 Q1,2010-2011
04,2010,CKD,139,9986,2010-04-01,2010 Q1,2010-2011
05,2010,CKD,136,10122,2010-05-01,2010 Q2,2010-2011
06,2010,CKD,111,10233,2010-06-01,2010 Q2,2010-2011
07,2010,CKD,100,10333,2010-07-01,2010 Q2,2010-2011
08,2010,CKD,115,10448,2010-08-01,2010 Q2,2010-2011
09,2010,CKD,106,10554,2010-09-01,2010 Q3,2010-2011
10,2010,CKD,95,10649,2010-10-01,2010 Q3,2010-2011
11,2010,CKD,115,10764,2010-11-01,2010 Q3,2010-2011
12,2010,CKD,97,10861,2010-12-01,2010 Q3,2010-2011
01,2011,CKD,107,10968,2011-01-01,2011 Q1,2010-2011
02,2011,CKD,74,11042,2011-02-01,2011 Q1,2010-2011
03,2011,CKD,89,11131,2011-03-01,2011 Q1,2010-2011
04,2011,CKD,82,11213,2011-04-01,2011 Q1,2010-2011
05,2011,CKD,75,11288,2011-05-01,2011 Q2,2010-2011
06,2011,CKD,70,11358,2011-06-01,2011 Q2,2010-2011
07,2011,CKD,71,11429,2011-07-01,2011 Q2,2010-2011
08,2011,CKD,72,11501,2011-08-01,2011 Q2,2010-2011
09,2011,CKD,76,11577,2011-09-01,2011 Q3,2010-2011
10,2011,CKD,71,11648,2011-10-01,2011 Q3,2010-2011
11,2011,CKD,66,11714,2011-11-01,2011 Q3,2010-2011
12,2011,CKD,62,11776,2011-12-01,2011 Q3,2010-2011
01,2012,CKD,518,12294,2012-01-01,2012 Q1,2012-2013
02,2012,CKD,527,12821,2012-02-01,2012 Q1,2012-2013
03,2012,CKD,560,13381,2012-03-01,2012 Q1,2012-2013
04,2012,CKD,569,13950,2012-04-01,2012 Q1,2012-2013
05,2012,CKD,570,14520,2012-05-01,2012 Q2,2012-2013
06,2012,CKD,596,15116,2012-06-01,2012 Q2,2012-2013
07,2012,CKD,618,15734,2012-07-01,2012 Q2,2012-2013
08,2012,CKD,581,16315,2012-08-01,2012 Q2,2012-2013
09,2012,CKD,637,16952,2012-09-01,2012 Q3,2012-2013
10,2012,CKD,626,17578,2012-10-01,2012 Q3,2012-2013
11,2012,CKD,590,18168,2012-11-01,2012 Q3,2012-2013
12,2012,CKD,657,18825,2012-12-01,2012 Q3,2012-2013
01,2013,CKD,138,18963,2013-01-01,2013 Q1,2012-2013
02,2013,CKD,132,19095,2013-02-01,2013 Q1,2012-2013
03,2013,CKD,110,19205,2013-03-01,2013 Q1,2012-2013
04,2013,CKD,130,19335,2013-04-01,2013 Q1,2012-2013
05,2013,CKD,113,19448,2013-05-01,2013 Q2,2012-2013
06,2013,CKD,116,19564,2013-06-01,2013 Q2,2012-2013
07,2013,CKD,98,19662,2013-07-01,2013 Q2,2012-2013
08,2013,CKD,105,19767,2013-08-01,2013 Q2,2012-2013
09,2013,CKD,118,19885,2013-09-01,2013 Q3,2012-2013
10,2013,CKD,106,19991,2013-10-01,2013 Q3,2012-2013
11,2013,CKD,85,20076,2013-11-01,2013 Q3,2012-2013
12,2013,CKD,94,20170,2013-12-01,2013 Q3,2012-2013
01,2014,CKD,83,20253,2014-01-01,2014 Q1,2014-2015
02,2014,CKD,96,20349,2014-02-01,2014 Q1,2014-2015
03,2014,CKD,90,20439,2014-03-01,2014 Q1,2014-2015
04,2014,CKD,96,20535,2014-04-01,2014 Q1,2014-2015
05,2014,CKD,95,20630,2014-05-01,2014 Q2,2014-2015
06,2014,CKD,88,20718,2014-06-01,2014 Q2,2014-2015
07,2014,CKD,84,20802,2014-07-01,2014 Q2,2014-2015
08,2014,CKD,64,20866,2014-08-01,2014 Q2,2014-2015
09,2014,CKD,79,20945,2014-09-01,2014 Q3,2014-2015
10,2014,CKD,87,21032,2014-10-01,2014 Q3,2014-2015
11,2014,CKD,69,21101,2014-11-01,2014 Q3,2014-2015
12,2014,CKD,69,21170,2014-12-01,2014 Q3,2014-2015
01,2015,CKD,565,21735,2015-01-01,2015 Q1,2014-2015
02,2015,CKD,526,22261,2015-02-01,2015 Q1,2014-2015
03,2015,CKD,616,22877,2015-03-01,2015 Q1,2014-2015
04,2015,CKD,616,23493,2015-04-01,2015 Q1,2014-2015
05,2015,CKD,660,24153,2015-05-01,2015 Q2,2014-2015
06,2015,CKD,626,24779,2015-06-01,2015 Q2,2014-2015
07,2015,CKD,647,25426,2015-07-01,2015 Q2,2014-2015
08,2015,CKD,618,26044,2015-08-01,2015 Q2,2014-2015
09,2015,CKD,611,26655,2015-09-01,2015 Q3,2014-2015
10,2015,CKD,621,27276,2015-10-01,2015 Q3,2014-2015
11,2015,CKD,662,27938,2015-11-01,2015 Q3,2014-2015
12,2015,CKD,657,28595,2015-12-01,2015 Q3,2014-2015
01,2016,CKD,167,28762,2016-01-01,2016 Q1,2016-2017
02,2016,CKD,146,28908,2016-02-01,2016 Q1,2016-2017
03,2016,CKD,144,29052,2016-03-01,2016 Q1,2016-2017
04,2016,CKD,137,29189,2016-04-01,2016 Q1,2016-2017
05,2016,CKD,130,29319,2016-05-01,2016 Q2,2016-2017
06,2016,CKD,138,29457,2016-06-01,2016 Q2,2016-2017
07,2016,CKD,121,29578,2016-07-01,2016 Q2,2016-2017
08,2016,CKD,124,29702,2016-08-01,2016 Q2,2016-2017
09,2016,CKD,127,29829,2016-09-01,2016 Q3,2016-2017
10,2016,CKD,114,29943,2016-10-01,2016 Q3,2016-2017
11,2016,CKD,115,30058,2016-11-01,2016 Q3,2016-2017
12,2016,CKD,102,30160,2016-12-01,2016 Q3,2016-2017
01,2017,CKD,117,30277,2017-01-01,2017 Q1,2016-2017
02,2017,CKD,111,30388,2017-02-01,2017 Q1,2016-2017
03,2017,CKD,89,30477,2017-03-01,2017 Q1,2016-2017
04,2017,CKD,94,30571,2017-04-01,2017 Q1,2016-2017
05,2017,CKD,100,30671,2017-05-01,2017 Q2,2016-2017
06,2017,CKD,95,30766,2017-06-01,2017 Q2,2016-2017
07,2017,CKD,114,30880,2017-07-01,2017 Q2,2016-2017
08,2017,CKD,93,30973,2017-08-01,2017 Q2,2016-2017
09,2017,CKD,88,31061,2017-09-01,2017 Q3,2016-2017
10,2017,CKD,102,31163,2017-10-01,2017 Q3,2016-2017
11,2017,CKD,99,31262,2017-11-01,2017 Q3,2016-2017
12,2017,CKD,89,31351,2017-12-01,2017 Q3,2016-2017
01,2018,CKD,645,31996,2018-01-01,2018 Q1,2018-2019
02,2018,CKD,589,32585,2018-02-01,2018 Q1,2018-2019
03,2018,CKD,652,33237,2018-03-01,2018 Q1,2018-2019
04,2018,CKD,674,33911,2018-04-01,2018 Q1,2018-2019
05,2018,CKD,664,34575,2018-05-01,2018 Q2,2018-2019
06,2018,CKD,656,35231,2018-06-01,2018 Q2,2018-2019
07,2018,CKD,679,35910,2018-07-01,2018 Q2,2018-2019
08,2018,CKD,668,36578,2018-08-01,2018 Q2,2018-2019
09,2018,CKD,619,37197,2018-09-01,2018 Q3,2018-2019
10,2018,CKD,691,37888,2018-10-01,2018 Q3,2018-2019
11,2018,CKD,659,38547,2018-11-01,2018 Q3,2018-2019
12,2018,CKD,675,39222,2018-12-01,2018 Q3,2018-2019
01,2019,CKD,157,39379,2019-01-01,2019 Q1,2018-2019
02,2019,CKD,102,39481,2019-02-01,2019 Q1,2018-2019
03,2019,CKD,129,39610,2019-03-01,2019 Q1,2018-2019
04,2019,CKD,97,39707,2019-04-01,2019 Q1,2018-2019
05,2019,CKD,100,39807,2019-05-01,2019 Q2,2018-2019
06,2019,CKD,84,39891,2019-06-01,2019 Q2,2018-2019
07,2019,CKD,87,39978,2019-07-01,2019 Q2,2018-2019
08,2019,CKD,88,40066,2019-08-01,2019 Q2,2018-2019
09,2019,CKD,77,40143,2019-09-01,2019 Q3,2018-2019
10,2019,CKD,67,40210,2019-10-01,2019 Q3,2018-2019
11,2019,CKD,46,40256,2019-11-01,2019 Q3,2018-2019
12,2019,CKD,75,40331,2019-12-01,2019 Q3,2018-2019
01,2020,CKD,73,40404,2020-01-01,2020 Q1,2020-2021
02,2020,CKD,64,40468,2020-02-01,2020 Q1,2020-2021
03,2020,CKD,47,40515,2020-03-01,2020 Q1,2020-2021
04,2020,CKD,57,40572,2020-04-01,2020 Q1,2020-2021
05,2020,CKD,48,40620,2020-05-01,2020 Q2,2020-2021
06,2020,CKD,39,40659,2020-06-01,2020 Q2,2020-2021
07,2020,CKD,41,40700,2020-07-01,2020 Q2,2020-2021
08,2020,CKD,36,40736,2020-08-01,2020 Q2,2020-2021
09,2020,CKD,32,40768,2020-09-01,2020 Q3,2020-2021
10,2020,CKD,28,40796,2020-10-01,2020 Q3,2020-2021
11,2020,CKD,30,40826,2020-11-01,2020 Q3,2020-2021
12,2020,CKD,24,40850,2020-12-01,2020 Q3,2020-2021
01,2021,CKD,19,40869,2021-01-01,2021 Q1,2020-2021
02,2021,CKD,20,40889,2021-02-01,2021 Q1,2020-2021
03,2021,CKD,24,40913,2021-03-01,2021 Q1,2020-2021
04,2021,CKD,11,40924,2021-04-01,2021 Q1,2020-2021
05,2021,CKD,6,40930,2021-05-01,2021 Q2,2020-2021
06,2021,CKD,11,40941,2021-06-01,2021 Q2,2020-2021
07,2021,CKD,3,40944,2021-07-01,2021 Q2,2020-2021
08,2021,CKD,7,40951,2021-08-01,2021 Q2,2020-2021
10,2021,CKD,1,40952,2021-10-01,2021 Q3,2020-2021
11,2006,Diabetes,1,1,2006-11-01,2006 Q3,2006-2007
04,2007,Diabetes,1,2,2007-04-01,2007 Q1,2006-2007
05,2007,Diabetes,1,3,2007-05-01,2007 Q2,2006-2007
06,2007,Diabetes,1,4,2007-06-01,2007 Q2,2006-2007
08,2007,Diabetes,1,5,2007-08-01,2007 Q2,2006-2007
10,2007,Diabetes,3,8,2007-10-01,2007 Q3,2006-2007
11,2007,Diabetes,1,9,2007-11-01,2007 Q3,2006-2007
02,2008,Diabetes,1,10,2008-02-01,2008 Q1,2008-2009
04,2008,Diabetes,1,11,2008-04-01,2008 Q1,2008-2009
06,2008,Diabetes,1,12,2008-06-01,2008 Q2,2008-2009
08,2008,Diabetes,1,13,2008-08-01,2008 Q2,2008-2009
09,2008,Diabetes,1,14,2008-09-01,2008 Q3,2008-2009
11,2008,Diabetes,1,15,2008-11-01,2008 Q3,2008-2009
12,2008,Diabetes,3,18,2008-12-01,2008 Q3,2008-2009
01,2009,Diabetes,728,746,2009-01-01,2009 Q1,2008-2009
02,2009,Diabetes,692,1438,2009-02-01,2009 Q1,2008-2009
03,2009,Diabetes,824,2262,2009-03-01,2009 Q1,2008-2009
04,2009,Diabetes,771,3033,2009-04-01,2009 Q1,2008-2009
05,2009,Diabetes,792,3825,2009-05-01,2009 Q2,2008-2009
06,2009,Diabetes,751,4576,2009-06-01,2009 Q2,2008-2009
07,2009,Diabetes,833,5409,2009-07-01,2009 Q2,2008-2009
08,2009,Diabetes,841,6250,2009-08-01,2009 Q2,2008-2009
09,2009,Diabetes,815,7065,2009-09-01,2009 Q3,2008-2009
10,2009,Diabetes,858,7923,2009-10-01,2009 Q3,2008-2009
11,2009,Diabetes,785,8708,2009-11-01,2009 Q3,2008-2009
12,2009,Diabetes,870,9578,2009-12-01,2009 Q3,2008-2009
01,2010,Diabetes,121,9699,2010-01-01,2010 Q1,2010-2011
02,2010,Diabetes,84,9783,2010-02-01,2010 Q1,2010-2011
03,2010,Diabetes,90,9873,2010-03-01,2010 Q1,2010-2011
04,2010,Diabetes,82,9955,2010-04-01,2010 Q1,2010-2011
05,2010,Diabetes,77,10032,2010-05-01,2010 Q2,2010-2011
06,2010,Diabetes,63,10095,2010-06-01,2010 Q2,2010-2011
07,2010,Diabetes,64,10159,2010-07-01,2010 Q2,2010-2011
08,2010,Diabetes,58,10217,2010-08-01,2010 Q2,2010-2011
09,2010,Diabetes,54,10271,2010-09-01,2010 Q3,2010-2011
10,2010,Diabetes,59,10330,2010-10-01,2010 Q3,2010-2011
11,2010,Diabetes,58,10388,2010-11-01,2010 Q3,2010-2011
12,2010,Diabetes,65,10453,2010-12-01,2010 Q3,2010-2011
01,2011,Diabetes,45,10498,2011-01-01,2011 Q1,2010-2011
02,2011,Diabetes,45,10543,2011-02-01,2011 Q1,2010-2011
03,2011,Diabetes,39,10582,2011-03-01,2011 Q1,2010-2011
04,2011,Diabetes,35,10617,2011-04-01,2011 Q1,2010-2011
05,2011,Diabetes,38,10655,2011-05-01,2011 Q2,2010-2011
06,2011,Diabetes,55,10710,2011-06-01,2011 Q2,2010-2011
07,2011,Diabetes,47,10757,2011-07-01,2011 Q2,2010-2011
08,2011,Diabetes,41,10798,2011-08-01,2011 Q2,2010-2011
09,2011,Diabetes,65,10863,2011-09-01,2011 Q3,2010-2011
10,2011,Diabetes,38,10901,2011-10-01,2011 Q3,2010-2011
11,2011,Diabetes,46,10947,2011-11-01,2011 Q3,2010-2011
12,2011,Diabetes,49,10996,2011-12-01,2011 Q3,2010-2011
01,2012,Diabetes,623,11619,2012-01-01,2012 Q1,2012-2013
02,2012,Diabetes,542,12161,2012-02-01,2012 Q1,2012-2013
03,2012,Diabetes,587,12748,2012-03-01,2012 Q1,2012-2013
04,2012,Diabetes,610,13358,2012-04-01,2012 Q1,2012-2013
05,2012,Diabetes,634,13992,2012-05-01,2012 Q2,2012-2013
06,2012,Diabetes,574,14566,2012-06-01,2012 Q2,2012-2013
07,2012,Diabetes,634,15200,2012-07-01,2012 Q2,2012-2013
08,2012,Diabetes,611,15811,2012-08-01,2012 Q2,2012-2013
09,2012,Diabetes,610,16421,2012-09-01,2012 Q3,2012-2013
10,2012,Diabetes,594,17015,2012-10-01,2012 Q3,2012-2013
11,2012,Diabetes,609,17624,2012-11-01,2012 Q3,2012-2013
12,2012,Diabetes,649,18273,2012-12-01,2012 Q3,2012-2013
01,2013,Diabetes,94,18367,2013-01-01,2013 Q1,2012-2013
02,2013,Diabetes,71,18438,2013-02-01,2013 Q1,2012-2013
03,2013,Diabetes,88,18526,2013-03-01,2013 Q1,2012-2013
04,2013,Diabetes,86,18612,2013-04-01,2013 Q1,2012-2013
05,2013,Diabetes,87,18699,2013-05-01,2013 Q2,2012-2013
06,2013,Diabetes,65,18764,2013-06-01,2013 Q2,2012-2013
07,2013,Diabetes,59,18823,2013-07-01,2013 Q2,2012-2013
08,2013,Diabetes,62,18885,2013-08-01,2013 Q2,2012-2013
09,2013,Diabetes,66,18951,2013-09-01,2013 Q3,2012-2013
10,2013,Diabetes,68,19019,2013-10-01,2013 Q3,2012-2013
11,2013,Diabetes,69,19088,2013-11-01,2013 Q3,2012-2013
12,2013,Diabetes,75,19163,2013-12-01,2013 Q3,2012-2013
01,2014,Diabetes,63,19226,2014-01-01,2014 Q1,2014-2015
02,2014,Diabetes,43,19269,2014-02-01,2014 Q1,2014-2015
03,2014,Diabetes,58,19327,2014-03-01,2014 Q1,2014-2015
04,2014,Diabetes,34,19361,2014-04-01,2014 Q1,2014-2015
05,2014,Diabetes,54,19415,2014-05-01,2014 Q2,2014-2015
06,2014,Diabetes,32,19447,2014-06-01,2014 Q2,2014-2015
07,2014,Diabetes,72,19519,2014-07-01,2014 Q2,2014-2015
08,2014,Diabetes,48,19567,2014-08-01,2014 Q2,2014-2015
09,2014,Diabetes,51,19618,2014-09-01,2014 Q3,2014-2015
10,2014,Diabetes,58,19676,2014-10-01,2014 Q3,2014-2015
11,2014,Diabetes,51,19727,2014-11-01,2014 Q3,2014-2015
12,2014,Diabetes,37,19764,2014-12-01,2014 Q3,2014-2015
01,2015,Diabetes,538,20302,2015-01-01,2015 Q1,2014-2015
02,2015,Diabetes,490,20792,2015-02-01,2015 Q1,2014-2015
03,2015,Diabetes,585,21377,2015-03-01,2015 Q1,2014-2015
04,2015,Diabetes,592,21969,2015-04-01,2015 Q1,2014-2015
05,2015,Diabetes,622,22591,2015-05-01,2015 Q2,2014-2015
06,2015,Diabetes,607,23198,2015-06-01,2015 Q2,2014-2015
07,2015,Diabetes,619,23817,2015-07-01,2015 Q2,2014-2015
08,2015,Diabetes,583,24400,2015-08-01,2015 Q2,2014-2015
09,2015,Diabetes,583,24983,2015-09-01,2015 Q3,2014-2015
10,2015,Diabetes,624,25607,2015-10-01,2015 Q3,2014-2015
11,2015,Diabetes,608,26215,2015-11-01,2015 Q3,2014-2015
12,2015,Diabetes,612,26827,2015-12-01,2015 Q3,2014-2015
01,2016,Diabetes,87,26914,2016-01-01,2016 Q1,2016-2017
02,2016,Diabetes,54,26968,2016-02-01,2016 Q1,2016-2017
03,2016,Diabetes,86,27054,2016-03-01,2016 Q1,2016-2017
04,2016,Diabetes,80,27134,2016-04-01,2016 Q1,2016-2017
05,2016,Diabetes,63,27197,2016-05-01,2016 Q2,2016-2017
06,2016,Diabetes,69,27266,2016-06-01,2016 Q2,2016-2017
07,2016,Diabetes,64,27330,2016-07-01,2016 Q2,2016-2017
08,2016,Diabetes,76,27406,2016-08-01,2016 Q2,2016-2017
09,2016,Diabetes,66,27472,2016-09-01,2016 Q3,2016-2017
10,2016,Diabetes,73,27545,2016-10-01,2016 Q3,2016-2017
11,2016,Diabetes,83,27628,2016-11-01,2016 Q3,2016-2017
12,2016,Diabetes,55,27683,2016-12-01,2016 Q3,2016-2017
01,2017,Diabetes,49,27732,2017-01-01,2017 Q1,2016-2017
02,2017,Diabetes,64,27796,2017-02-01,2017 Q1,2016-2017
03,2017,Diabetes,49,27845,2017-03-01,2017 Q1,2016-2017
04,2017,Diabetes,54,27899,2017-04-01,2017 Q1,2016-2017
05,2017,Diabetes,58,27957,2017-05-01,2017 Q2,2016-2017
06,2017,Diabetes,49,28006,2017-06-01,2017 Q2,2016-2017
07,2017,Diabetes,58,28064,2017-07-01,2017 Q2,2016-2017
08,2017,Diabetes,63,28127,2017-08-01,2017 Q2,2016-2017
09,2017,Diabetes,68,28195,2017-09-01,2017 Q3,2016-2017
10,2017,Diabetes,53,28248,2017-10-01,2017 Q3,2016-2017
11,2017,Diabetes,54,28302,2017-11-01,2017 Q3,2016-2017
12,2017,Diabetes,62,28364,2017-12-01,2017 Q3,2016-2017
01,2018,Diabetes,613,28977,2018-01-01,2018 Q1,2018-2019
02,2018,Diabetes,511,29488,2018-02-01,2018 Q1,2018-2019
03,2018,Diabetes,595,30083,2018-03-01,2018 Q1,2018-2019
04,2018,Diabetes,532,30615,2018-04-01,2018 Q1,2018-2019
05,2018,Diabetes,580,31195,2018-05-01,2018 Q2,2018-2019
06,2018,Diabetes,540,31735,2018-06-01,2018 Q2,2018-2019
07,2018,Diabetes,566,32301,2018-07-01,2018 Q2,2018-2019
08,2018,Diabetes,546,32847,2018-08-01,2018 Q2,2018-2019
09,2018,Diabetes,500,33347,2018-09-01,2018 Q3,2018-2019
10,2018,Diabetes,611,33958,2018-10-01,2018 Q3,2018-2019
11,2018,Diabetes,576,34534,2018-11-01,2018 Q3,2018-2019
12,2018,Diabetes,560,35094,2018-12-01,2018 Q3,2018-2019
01,2019,Diabetes,87,35181,2019-01-01,2019 Q1,2018-2019
02,2019,Diabetes,69,35250,2019-02-01,2019 Q1,2018-2019
03,2019,Diabetes,61,35311,2019-03-01,2019 Q1,2018-2019
04,2019,Diabetes,61,35372,2019-04-01,2019 Q1,2018-2019
05,2019,Diabetes,44,35416,2019-05-01,2019 Q2,2018-2019
06,2019,Diabetes,54,35470,2019-06-01,2019 Q2,2018-2019
07,2019,Diabetes,43,35513,2019-07-01,2019 Q2,2018-2019
08,2019,Diabetes,39,35552,2019-08-01,2019 Q2,2018-2019
09,2019,Diabetes,35,35587,2019-09-01,2019 Q3,2018-2019
10,2019,Diabetes,37,35624,2019-10-01,2019 Q3,2018-2019
11,2019,Diabetes,34,35658,2019-11-01,2019 Q3,2018-2019
12,2019,Diabetes,28,35686,2019-12-01,2019 Q3,2018-2019
01,2020,Diabetes,42,35728,2020-01-01,2020 Q1,2020-2021
02,2020,Diabetes,40,35768,2020-02-01,2020 Q1,2020-2021
03,2020,Diabetes,25,35793,2020-03-01,2020 Q1,2020-2021
04,2020,Diabetes,33,35826,2020-04-01,2020 Q1,2020-2021
05,2020,Diabetes,13,35839,2020-05-01,2020 Q2,2020-2021
06,2020,Diabetes,23,35862,2020-06-01,2020 Q2,2020-2021
07,2020,Diabetes,27,35889,2020-07-01,2020 Q2,2020-2021
08,2020,Diabetes,19,35908,2020-08-01,2020 Q2,2020-2021
09,2020,Diabetes,13,35921,2020-09-01,2020 Q3,2020-2021
10,2020,Diabetes,15,35936,2020-10-01,2020 Q3,2020-2021
11,2020,Diabetes,14,35950,2020-11-01,2020 Q3,2020-2021
12,2020,Diabetes,11,35961,2020-12-01,2020 Q3,2020-2021
01,2021,Diabetes,7,35968,2021-01-01,2021 Q1,2020-2021
02,2021,Diabetes,8,35976,2021-02-01,2021 Q1,2020-2021
03,2021,Diabetes,8,35984,2021-03-01,2021 Q1,2020-2021
04,2021,Diabetes,4,35988,2021-04-01,2021 Q1,2020-2021
05,2021,Diabetes,3,35991,2021-05-01,2021 Q2,2020-2021
06,2021,Diabetes,4,35995,2021-06-01,2021 Q2,2020-2021
07,2021,Diabetes,4,35999,2021-07-01,2021 Q2,2020-2021
08,2021,Diabetes,2,36001,2021-08-01,2021 Q2,2020-2021
10,2021,Diabetes,1,36002,2021-10-01,2021 Q3,2020-2021
04,2006,Dyslipidemia,1,1,2006-04-01,2006 Q1,2006-2007
08,2006,Dyslipidemia,1,2,2006-08-01,2006 Q2,2006-2007
02,2007,Dyslipidemia,1,3,2007-02-01,2007 Q1,2006-2007
06,2007,Dyslipidemia,1,4,2007-06-01,2007 Q2,2006-2007
10,2007,Dyslipidemia,3,7,2007-10-01,2007 Q3,2006-2007
11,2007,Dyslipidemia,1,8,2007-11-01,2007 Q3,2006-2007
04,2008,Dyslipidemia,2,10,2008-04-01,2008 Q1,2008-2009
07,2008,Dyslipidemia,1,11,2008-07-01,2008 Q2,2008-2009
12,2008,Dyslipidemia,3,14,2008-12-01,2008 Q3,2008-2009
01,2009,Dyslipidemia,323,337,2009-01-01,2009 Q1,2008-2009
02,2009,Dyslipidemia,328,665,2009-02-01,2009 Q1,2008-2009
03,2009,Dyslipidemia,367,1032,2009-03-01,2009 Q1,2008-2009
04,2009,Dyslipidemia,358,1390,2009-04-01,2009 Q1,2008-2009
05,2009,Dyslipidemia,403,1793,2009-05-01,2009 Q2,2008-2009
06,2009,Dyslipidemia,430,2223,2009-06-01,2009 Q2,2008-2009
07,2009,Dyslipidemia,433,2656,2009-07-01,2009 Q2,2008-2009
08,2009,Dyslipidemia,400,3056,2009-08-01,2009 Q2,2008-2009
09,2009,Dyslipidemia,403,3459,2009-09-01,2009 Q3,2008-2009
10,2009,Dyslipidemia,452,3911,2009-10-01,2009 Q3,2008-2009
11,2009,Dyslipidemia,458,4369,2009-11-01,2009 Q3,2008-2009
12,2009,Dyslipidemia,425,4794,2009-12-01,2009 Q3,2008-2009
01,2010,Dyslipidemia,101,4895,2010-01-01,2010 Q1,2010-2011
02,2010,Dyslipidemia,82,4977,2010-02-01,2010 Q1,2010-2011
03,2010,Dyslipidemia,66,5043,2010-03-01,2010 Q1,2010-2011
04,2010,Dyslipidemia,61,5104,2010-04-01,2010 Q1,2010-2011
05,2010,Dyslipidemia,66,5170,2010-05-01,2010 Q2,2010-2011
06,2010,Dyslipidemia,51,5221,2010-06-01,2010 Q2,2010-2011
07,2010,Dyslipidemia,64,5285,2010-07-01,2010 Q2,2010-2011
08,2010,Dyslipidemia,65,5350,2010-08-01,2010 Q2,2010-2011
09,2010,Dyslipidemia,51,5401,2010-09-01,2010 Q3,2010-2011
10,2010,Dyslipidemia,59,5460,2010-10-01,2010 Q3,2010-2011
11,2010,Dyslipidemia,53,5513,2010-11-01,2010 Q3,2010-2011
12,2010,Dyslipidemia,52,5565,2010-12-01,2010 Q3,2010-2011
01,2011,Dyslipidemia,55,5620,2011-01-01,2011 Q1,2010-2011
02,2011,Dyslipidemia,43,5663,2011-02-01,2011 Q1,2010-2011
03,2011,Dyslipidemia,52,5715,2011-03-01,2011 Q1,2010-2011
04,2011,Dyslipidemia,59,5774,2011-04-01,2011 Q1,2010-2011
05,2011,Dyslipidemia,62,5836,2011-05-01,2011 Q2,2010-2011
06,2011,Dyslipidemia,53,5889,2011-06-01,2011 Q2,2010-2011
07,2011,Dyslipidemia,46,5935,2011-07-01,2011 Q2,2010-2011
08,2011,Dyslipidemia,37,5972,2011-08-01,2011 Q2,2010-2011
09,2011,Dyslipidemia,38,6010,2011-09-01,2011 Q3,2010-2011
10,2011,Dyslipidemia,41,6051,2011-10-01,2011 Q3,2010-2011
11,2011,Dyslipidemia,34,6085,2011-11-01,2011 Q3,2010-2011
12,2011,Dyslipidemia,37,6122,2011-12-01,2011 Q3,2010-2011
01,2012,Dyslipidemia,267,6389,2012-01-01,2012 Q1,2012-2013
02,2012,Dyslipidemia,271,6660,2012-02-01,2012 Q1,2012-2013
03,2012,Dyslipidemia,271,6931,2012-03-01,2012 Q1,2012-2013
04,2012,Dyslipidemia,272,7203,2012-04-01,2012 Q1,2012-2013
05,2012,Dyslipidemia,270,7473,2012-05-01,2012 Q2,2012-2013
06,2012,Dyslipidemia,270,7743,2012-06-01,2012 Q2,2012-2013
07,2012,Dyslipidemia,280,8023,2012-07-01,2012 Q2,2012-2013
08,2012,Dyslipidemia,299,8322,2012-08-01,2012 Q2,2012-2013
09,2012,Dyslipidemia,279,8601,2012-09-01,2012 Q3,2012-2013
10,2012,Dyslipidemia,290,8891,2012-10-01,2012 Q3,2012-2013
11,2012,Dyslipidemia,301,9192,2012-11-01,2012 Q3,2012-2013
12,2012,Dyslipidemia,280,9472,2012-12-01,2012 Q3,2012-2013
01,2013,Dyslipidemia,99,9571,2013-01-01,2013 Q1,2012-2013
02,2013,Dyslipidemia,58,9629,2013-02-01,2013 Q1,2012-2013
03,2013,Dyslipidemia,61,9690,2013-03-01,2013 Q1,2012-2013
04,2013,Dyslipidemia,63,9753,2013-04-01,2013 Q1,2012-2013
05,2013,Dyslipidemia,73,9826,2013-05-01,2013 Q2,2012-2013
06,2013,Dyslipidemia,51,9877,2013-06-01,2013 Q2,2012-2013
07,2013,Dyslipidemia,56,9933,2013-07-01,2013 Q2,2012-2013
08,2013,Dyslipidemia,60,9993,2013-08-01,2013 Q2,2012-2013
09,2013,Dyslipidemia,69,10062,2013-09-01,2013 Q3,2012-2013
10,2013,Dyslipidemia,60,10122,2013-10-01,2013 Q3,2012-2013
11,2013,Dyslipidemia,69,10191,2013-11-01,2013 Q3,2012-2013
12,2013,Dyslipidemia,61,10252,2013-12-01,2013 Q3,2012-2013
01,2014,Dyslipidemia,55,10307,2014-01-01,2014 Q1,2014-2015
02,2014,Dyslipidemia,60,10367,2014-02-01,2014 Q1,2014-2015
03,2014,Dyslipidemia,54,10421,2014-03-01,2014 Q1,2014-2015
04,2014,Dyslipidemia,61,10482,2014-04-01,2014 Q1,2014-2015
05,2014,Dyslipidemia,67,10549,2014-05-01,2014 Q2,2014-2015
06,2014,Dyslipidemia,65,10614,2014-06-01,2014 Q2,2014-2015
07,2014,Dyslipidemia,87,10701,2014-07-01,2014 Q2,2014-2015
08,2014,Dyslipidemia,72,10773,2014-08-01,2014 Q2,2014-2015
09,2014,Dyslipidemia,84,10857,2014-09-01,2014 Q3,2014-2015
10,2014,Dyslipidemia,85,10942,2014-10-01,2014 Q3,2014-2015
11,2014,Dyslipidemia,86,11028,2014-11-01,2014 Q3,2014-2015
12,2014,Dyslipidemia,106,11134,2014-12-01,2014 Q3,2014-2015
01,2015,Dyslipidemia,596,11730,2015-01-01,2015 Q1,2014-2015
02,2015,Dyslipidemia,543,12273,2015-02-01,2015 Q1,2014-2015
03,2015,Dyslipidemia,628,12901,2015-03-01,2015 Q1,2014-2015
04,2015,Dyslipidemia,649,13550,2015-04-01,2015 Q1,2014-2015
05,2015,Dyslipidemia,667,14217,2015-05-01,2015 Q2,2014-2015
06,2015,Dyslipidemia,672,14889,2015-06-01,2015 Q2,2014-2015
07,2015,Dyslipidemia,694,15583,2015-07-01,2015 Q2,2014-2015
08,2015,Dyslipidemia,658,16241,2015-08-01,2015 Q2,2014-2015
09,2015,Dyslipidemia,705,16946,2015-09-01,2015 Q3,2014-2015
10,2015,Dyslipidemia,778,17724,2015-10-01,2015 Q3,2014-2015
11,2015,Dyslipidemia,675,18399,2015-11-01,2015 Q3,2014-2015
12,2015,Dyslipidemia,729,19128,2015-12-01,2015 Q3,2014-2015
01,2016,Dyslipidemia,223,19351,2016-01-01,2016 Q1,2016-2017
02,2016,Dyslipidemia,189,19540,2016-02-01,2016 Q1,2016-2017
03,2016,Dyslipidemia,241,19781,2016-03-01,2016 Q1,2016-2017
04,2016,Dyslipidemia,247,20028,2016-04-01,2016 Q1,2016-2017
05,2016,Dyslipidemia,208,20236,2016-05-01,2016 Q2,2016-2017
06,2016,Dyslipidemia,240,20476,2016-06-01,2016 Q2,2016-2017
07,2016,Dyslipidemia,224,20700,2016-07-01,2016 Q2,2016-2017
08,2016,Dyslipidemia,238,20938,2016-08-01,2016 Q2,2016-2017
09,2016,Dyslipidemia,237,21175,2016-09-01,2016 Q3,2016-2017
10,2016,Dyslipidemia,234,21409,2016-10-01,2016 Q3,2016-2017
11,2016,Dyslipidemia,267,21676,2016-11-01,2016 Q3,2016-2017
12,2016,Dyslipidemia,235,21911,2016-12-01,2016 Q3,2016-2017
01,2017,Dyslipidemia,247,22158,2017-01-01,2017 Q1,2016-2017
02,2017,Dyslipidemia,245,22403,2017-02-01,2017 Q1,2016-2017
03,2017,Dyslipidemia,216,22619,2017-03-01,2017 Q1,2016-2017
04,2017,Dyslipidemia,207,22826,2017-04-01,2017 Q1,2016-2017
05,2017,Dyslipidemia,239,23065,2017-05-01,2017 Q2,2016-2017
06,2017,Dyslipidemia,232,23297,2017-06-01,2017 Q2,2016-2017
07,2017,Dyslipidemia,209,23506,2017-07-01,2017 Q2,2016-2017
08,2017,Dyslipidemia,244,23750,2017-08-01,2017 Q2,2016-2017
09,2017,Dyslipidemia,210,23960,2017-09-01,2017 Q3,2016-2017
10,2017,Dyslipidemia,235,24195,2017-10-01,2017 Q3,2016-2017
11,2017,Dyslipidemia,205,24400,2017-11-01,2017 Q3,2016-2017
12,2017,Dyslipidemia,230,24630,2017-12-01,2017 Q3,2016-2017
01,2018,Dyslipidemia,1146,25776,2018-01-01,2018 Q1,2018-2019
02,2018,Dyslipidemia,1064,26840,2018-02-01,2018 Q1,2018-2019
03,2018,Dyslipidemia,1144,27984,2018-03-01,2018 Q1,2018-2019
04,2018,Dyslipidemia,1145,29129,2018-04-01,2018 Q1,2018-2019
05,2018,Dyslipidemia,1159,30288,2018-05-01,2018 Q2,2018-2019
06,2018,Dyslipidemia,1134,31422,2018-06-01,2018 Q2,2018-2019
07,2018,Dyslipidemia,1163,32585,2018-07-01,2018 Q2,2018-2019
08,2018,Dyslipidemia,1142,33727,2018-08-01,2018 Q2,2018-2019
09,2018,Dyslipidemia,1127,34854,2018-09-01,2018 Q3,2018-2019
10,2018,Dyslipidemia,1149,36003,2018-10-01,2018 Q3,2018-2019
11,2018,Dyslipidemia,1123,37126,2018-11-01,2018 Q3,2018-2019
12,2018,Dyslipidemia,1107,38233,2018-12-01,2018 Q3,2018-2019
01,2019,Dyslipidemia,241,38474,2019-01-01,2019 Q1,2018-2019
02,2019,Dyslipidemia,151,38625,2019-02-01,2019 Q1,2018-2019
03,2019,Dyslipidemia,176,38801,2019-03-01,2019 Q1,2018-2019
04,2019,Dyslipidemia,184,38985,2019-04-01,2019 Q1,2018-2019
05,2019,Dyslipidemia,156,39141,2019-05-01,2019 Q2,2018-2019
06,2019,Dyslipidemia,143,39284,2019-06-01,2019 Q2,2018-2019
07,2019,Dyslipidemia,160,39444,2019-07-01,2019 Q2,2018-2019
08,2019,Dyslipidemia,123,39567,2019-08-01,2019 Q2,2018-2019
09,2019,Dyslipidemia,128,39695,2019-09-01,2019 Q3,2018-2019
10,2019,Dyslipidemia,125,39820,2019-10-01,2019 Q3,2018-2019
11,2019,Dyslipidemia,111,39931,2019-11-01,2019 Q3,2018-2019
12,2019,Dyslipidemia,103,40034,2019-12-01,2019 Q3,2018-2019
01,2020,Dyslipidemia,99,40133,2020-01-01,2020 Q1,2020-2021
02,2020,Dyslipidemia,102,40235,2020-02-01,2020 Q1,2020-2021
03,2020,Dyslipidemia,96,40331,2020-03-01,2020 Q1,2020-2021
04,2020,Dyslipidemia,85,40416,2020-04-01,2020 Q1,2020-2021
05,2020,Dyslipidemia,70,40486,2020-05-01,2020 Q2,2020-2021
06,2020,Dyslipidemia,93,40579,2020-06-01,2020 Q2,2020-2021
07,2020,Dyslipidemia,57,40636,2020-07-01,2020 Q2,2020-2021
08,2020,Dyslipidemia,56,40692,2020-08-01,2020 Q2,2020-2021
09,2020,Dyslipidemia,41,40733,2020-09-01,2020 Q3,2020-2021
10,2020,Dyslipidemia,48,40781,2020-10-01,2020 Q3,2020-2021
11,2020,Dyslipidemia,52,40833,2020-11-01,2020 Q3,2020-2021
12,2020,Dyslipidemia,34,40867,2020-12-01,2020 Q3,2020-2021
01,2021,Dyslipidemia,33,40900,2021-01-01,2021 Q1,2020-2021
02,2021,Dyslipidemia,24,40924,2021-02-01,2021 Q1,2020-2021
03,2021,Dyslipidemia,19,40943,2021-03-01,2021 Q1,2020-2021
04,2021,Dyslipidemia,11,40954,2021-04-01,2021 Q1,2020-2021
05,2021,Dyslipidemia,20,40974,2021-05-01,2021 Q2,2020-2021
06,2021,Dyslipidemia,16,40990,2021-06-01,2021 Q2,2020-2021
07,2021,Dyslipidemia,4,40994,2021-07-01,2021 Q2,2020-2021
08,2021,Dyslipidemia,7,41001,2021-08-01,2021 Q2,2020-2021
09,2021,Dyslipidemia,3,41004,2021-09-01,2021 Q3,2020-2021
11,2021,Dyslipidemia,1,41005,2021-11-01,2021 Q3,2020-2021
08,2006,Heart disease,1,1,2006-08-01,2006 Q2,2006-2007
11,2006,Heart disease,1,2,2006-11-01,2006 Q3,2006-2007
06,2007,Heart disease,2,4,2007-06-01,2007 Q2,2006-2007
09,2007,Heart disease,1,5,2007-09-01,2007 Q3,2006-2007
10,2007,Heart disease,3,8,2007-10-01,2007 Q3,2006-2007
02,2008,Heart disease,2,10,2008-02-01,2008 Q1,2008-2009
03,2008,Heart disease,1,11,2008-03-01,2008 Q1,2008-2009
04,2008,Heart disease,3,14,2008-04-01,2008 Q1,2008-2009
06,2008,Heart disease,1,15,2008-06-01,2008 Q2,2008-2009
07,2008,Heart disease,1,16,2008-07-01,2008 Q2,2008-2009
08,2008,Heart disease,1,17,2008-08-01,2008 Q2,2008-2009
09,2008,Heart disease,2,19,2008-09-01,2008 Q3,2008-2009
10,2008,Heart disease,1,20,2008-10-01,2008 Q3,2008-2009
11,2008,Heart disease,1,21,2008-11-01,2008 Q3,2008-2009
12,2008,Heart disease,4,25,2008-12-01,2008 Q3,2008-2009
01,2009,Heart disease,983,1008,2009-01-01,2009 Q1,2008-2009
02,2009,Heart disease,1001,2009,2009-02-01,2009 Q1,2008-2009
03,2009,Heart disease,1092,3101,2009-03-01,2009 Q1,2008-2009
04,2009,Heart disease,1101,4202,2009-04-01,2009 Q1,2008-2009
05,2009,Heart disease,1054,5256,2009-05-01,2009 Q2,2008-2009
06,2009,Heart disease,1045,6301,2009-06-01,2009 Q2,2008-2009
07,2009,Heart disease,1150,7451,2009-07-01,2009 Q2,2008-2009
08,2009,Heart disease,1161,8612,2009-08-01,2009 Q2,2008-2009
09,2009,Heart disease,1188,9800,2009-09-01,2009 Q3,2008-2009
10,2009,Heart disease,1166,10966,2009-10-01,2009 Q3,2008-2009
11,2009,Heart disease,1155,12121,2009-11-01,2009 Q3,2008-2009
12,2009,Heart disease,1157,13278,2009-12-01,2009 Q3,2008-2009
01,2010,Heart disease,160,13438,2010-01-01,2010 Q1,2010-2011
02,2010,Heart disease,137,13575,2010-02-01,2010 Q1,2010-2011
03,2010,Heart disease,126,13701,2010-03-01,2010 Q1,2010-2011
04,2010,Heart disease,114,13815,2010-04-01,2010 Q1,2010-2011
05,2010,Heart disease,105,13920,2010-05-01,2010 Q2,2010-2011
06,2010,Heart disease,79,13999,2010-06-01,2010 Q2,2010-2011
07,2010,Heart disease,105,14104,2010-07-01,2010 Q2,2010-2011
08,2010,Heart disease,86,14190,2010-08-01,2010 Q2,2010-2011
09,2010,Heart disease,79,14269,2010-09-01,2010 Q3,2010-2011
10,2010,Heart disease,85,14354,2010-10-01,2010 Q3,2010-2011
11,2010,Heart disease,84,14438,2010-11-01,2010 Q3,2010-2011
12,2010,Heart disease,85,14523,2010-12-01,2010 Q3,2010-2011
01,2011,Heart disease,81,14604,2011-01-01,2011 Q1,2010-2011
02,2011,Heart disease,91,14695,2011-02-01,2011 Q1,2010-2011
03,2011,Heart disease,83,14778,2011-03-01,2011 Q1,2010-2011
04,2011,Heart disease,58,14836,2011-04-01,2011 Q1,2010-2011
05,2011,Heart disease,75,14911,2011-05-01,2011 Q2,2010-2011
06,2011,Heart disease,58,14969,2011-06-01,2011 Q2,2010-2011
07,2011,Heart disease,64,15033,2011-07-01,2011 Q2,2010-2011
08,2011,Heart disease,55,15088,2011-08-01,2011 Q2,2010-2011
09,2011,Heart disease,59,15147,2011-09-01,2011 Q3,2010-2011
10,2011,Heart disease,51,15198,2011-10-01,2011 Q3,2010-2011
11,2011,Heart disease,66,15264,2011-11-01,2011 Q3,2010-2011
12,2011,Heart disease,59,15323,2011-12-01,2011 Q3,2010-2011
01,2012,Heart disease,737,16060,2012-01-01,2012 Q1,2012-2013
02,2012,Heart disease,764,16824,2012-02-01,2012 Q1,2012-2013
03,2012,Heart disease,772,17596,2012-03-01,2012 Q1,2012-2013
04,2012,Heart disease,797,18393,2012-04-01,2012 Q1,2012-2013
05,2012,Heart disease,824,19217,2012-05-01,2012 Q2,2012-2013
06,2012,Heart disease,759,19976,2012-06-01,2012 Q2,2012-2013
07,2012,Heart disease,842,20818,2012-07-01,2012 Q2,2012-2013
08,2012,Heart disease,838,21656,2012-08-01,2012 Q2,2012-2013
09,2012,Heart disease,850,22506,2012-09-01,2012 Q3,2012-2013
10,2012,Heart disease,820,23326,2012-10-01,2012 Q3,2012-2013
11,2012,Heart disease,792,24118,2012-11-01,2012 Q3,2012-2013
12,2012,Heart disease,844,24962,2012-12-01,2012 Q3,2012-2013
01,2013,Heart disease,126,25088,2013-01-01,2013 Q1,2012-2013
02,2013,Heart disease,114,25202,2013-02-01,2013 Q1,2012-2013
03,2013,Heart disease,91,25293,2013-03-01,2013 Q1,2012-2013
04,2013,Heart disease,101,25394,2013-04-01,2013 Q1,2012-2013
05,2013,Heart disease,91,25485,2013-05-01,2013 Q2,2012-2013
06,2013,Heart disease,86,25571,2013-06-01,2013 Q2,2012-2013
07,2013,Heart disease,88,25659,2013-07-01,2013 Q2,2012-2013
08,2013,Heart disease,91,25750,2013-08-01,2013 Q2,2012-2013
09,2013,Heart disease,85,25835,2013-09-01,2013 Q3,2012-2013
10,2013,Heart disease,81,25916,2013-10-01,2013 Q3,2012-2013
11,2013,Heart disease,84,26000,2013-11-01,2013 Q3,2012-2013
12,2013,Heart disease,108,26108,2013-12-01,2013 Q3,2012-2013
01,2014,Heart disease,78,26186,2014-01-01,2014 Q1,2014-2015
02,2014,Heart disease,78,26264,2014-02-01,2014 Q1,2014-2015
03,2014,Heart disease,71,26335,2014-03-01,2014 Q1,2014-2015
04,2014,Heart disease,65,26400,2014-04-01,2014 Q1,2014-2015
05,2014,Heart disease,76,26476,2014-05-01,2014 Q2,2014-2015
06,2014,Heart disease,70,26546,2014-06-01,2014 Q2,2014-2015
07,2014,Heart disease,84,26630,2014-07-01,2014 Q2,2014-2015
08,2014,Heart disease,65,26695,2014-08-01,2014 Q2,2014-2015
09,2014,Heart disease,87,26782,2014-09-01,2014 Q3,2014-2015
10,2014,Heart disease,69,26851,2014-10-01,2014 Q3,2014-2015
11,2014,Heart disease,83,26934,2014-11-01,2014 Q3,2014-2015
12,2014,Heart disease,79,27013,2014-12-01,2014 Q3,2014-2015
01,2015,Heart disease,849,27862,2015-01-01,2015 Q1,2014-2015
02,2015,Heart disease,759,28621,2015-02-01,2015 Q1,2014-2015
03,2015,Heart disease,885,29506,2015-03-01,2015 Q1,2014-2015
04,2015,Heart disease,914,30420,2015-04-01,2015 Q1,2014-2015
05,2015,Heart disease,907,31327,2015-05-01,2015 Q2,2014-2015
06,2015,Heart disease,868,32195,2015-06-01,2015 Q2,2014-2015
07,2015,Heart disease,875,33070,2015-07-01,2015 Q2,2014-2015
08,2015,Heart disease,893,33963,2015-08-01,2015 Q2,2014-2015
09,2015,Heart disease,902,34865,2015-09-01,2015 Q3,2014-2015
10,2015,Heart disease,907,35772,2015-10-01,2015 Q3,2014-2015
11,2015,Heart disease,941,36713,2015-11-01,2015 Q3,2014-2015
12,2015,Heart disease,915,37628,2015-12-01,2015 Q3,2014-2015
01,2016,Heart disease,142,37770,2016-01-01,2016 Q1,2016-2017
02,2016,Heart disease,104,37874,2016-02-01,2016 Q1,2016-2017
03,2016,Heart disease,113,37987,2016-03-01,2016 Q1,2016-2017
04,2016,Heart disease,117,38104,2016-04-01,2016 Q1,2016-2017
05,2016,Heart disease,119,38223,2016-05-01,2016 Q2,2016-2017
06,2016,Heart disease,126,38349,2016-06-01,2016 Q2,2016-2017
07,2016,Heart disease,117,38466,2016-07-01,2016 Q2,2016-2017
08,2016,Heart disease,137,38603,2016-08-01,2016 Q2,2016-2017
09,2016,Heart disease,103,38706,2016-09-01,2016 Q3,2016-2017
10,2016,Heart disease,117,38823,2016-10-01,2016 Q3,2016-2017
11,2016,Heart disease,95,38918,2016-11-01,2016 Q3,2016-2017
12,2016,Heart disease,99,39017,2016-12-01,2016 Q3,2016-2017
01,2017,Heart disease,105,39122,2017-01-01,2017 Q1,2016-2017
02,2017,Heart disease,100,39222,2017-02-01,2017 Q1,2016-2017
03,2017,Heart disease,97,39319,2017-03-01,2017 Q1,2016-2017
04,2017,Heart disease,80,39399,2017-04-01,2017 Q1,2016-2017
05,2017,Heart disease,108,39507,2017-05-01,2017 Q2,2016-2017
06,2017,Heart disease,85,39592,2017-06-01,2017 Q2,2016-2017
07,2017,Heart disease,98,39690,2017-07-01,2017 Q2,2016-2017
08,2017,Heart disease,92,39782,2017-08-01,2017 Q2,2016-2017
09,2017,Heart disease,81,39863,2017-09-01,2017 Q3,2016-2017
10,2017,Heart disease,94,39957,2017-10-01,2017 Q3,2016-2017
11,2017,Heart disease,79,40036,2017-11-01,2017 Q3,2016-2017
12,2017,Heart disease,114,40150,2017-12-01,2017 Q3,2016-2017
01,2018,Heart disease,888,41038,2018-01-01,2018 Q1,2018-2019
02,2018,Heart disease,807,41845,2018-02-01,2018 Q1,2018-2019
03,2018,Heart disease,857,42702,2018-03-01,2018 Q1,2018-2019
04,2018,Heart disease,891,43593,2018-04-01,2018 Q1,2018-2019
05,2018,Heart disease,925,44518,2018-05-01,2018 Q2,2018-2019
06,2018,Heart disease,835,45353,2018-06-01,2018 Q2,2018-2019
07,2018,Heart disease,849,46202,2018-07-01,2018 Q2,2018-2019
08,2018,Heart disease,880,47082,2018-08-01,2018 Q2,2018-2019
09,2018,Heart disease,859,47941,2018-09-01,2018 Q3,2018-2019
10,2018,Heart disease,890,48831,2018-10-01,2018 Q3,2018-2019
11,2018,Heart disease,872,49703,2018-11-01,2018 Q3,2018-2019
12,2018,Heart disease,843,50546,2018-12-01,2018 Q3,2018-2019
01,2019,Heart disease,136,50682,2019-01-01,2019 Q1,2018-2019
02,2019,Heart disease,99,50781,2019-02-01,2019 Q1,2018-2019
03,2019,Heart disease,91,50872,2019-03-01,2019 Q1,2018-2019
04,2019,Heart disease,91,50963,2019-04-01,2019 Q1,2018-2019
05,2019,Heart disease,80,51043,2019-05-01,2019 Q2,2018-2019
06,2019,Heart disease,74,51117,2019-06-01,2019 Q2,2018-2019
07,2019,Heart disease,83,51200,2019-07-01,2019 Q2,2018-2019
08,2019,Heart disease,91,51291,2019-08-01,2019 Q2,2018-2019
09,2019,Heart disease,79,51370,2019-09-01,2019 Q3,2018-2019
10,2019,Heart disease,58,51428,2019-10-01,2019 Q3,2018-2019
11,2019,Heart disease,59,51487,2019-11-01,2019 Q3,2018-2019
12,2019,Heart disease,55,51542,2019-12-01,2019 Q3,2018-2019
01,2020,Heart disease,60,51602,2020-01-01,2020 Q1,2020-2021
02,2020,Heart disease,54,51656,2020-02-01,2020 Q1,2020-2021
03,2020,Heart disease,52,51708,2020-03-01,2020 Q1,2020-2021
04,2020,Heart disease,50,51758,2020-04-01,2020 Q1,2020-2021
05,2020,Heart disease,48,51806,2020-05-01,2020 Q2,2020-2021
06,2020,Heart disease,38,51844,2020-06-01,2020 Q2,2020-2021
07,2020,Heart disease,40,51884,2020-07-01,2020 Q2,2020-2021
08,2020,Heart disease,31,51915,2020-08-01,2020 Q2,2020-2021
09,2020,Heart disease,29,51944,2020-09-01,2020 Q3,2020-2021
10,2020,Heart disease,27,51971,2020-10-01,2020 Q3,2020-2021
11,2020,Heart disease,29,52000,2020-11-01,2020 Q3,2020-2021
12,2020,Heart disease,16,52016,2020-12-01,2020 Q3,2020-2021
01,2021,Heart disease,15,52031,2021-01-01,2021 Q1,2020-2021
02,2021,Heart disease,20,52051,2021-02-01,2021 Q1,2020-2021
03,2021,Heart disease,15,52066,2021-03-01,2021 Q1,2020-2021
04,2021,Heart disease,9,52075,2021-04-01,2021 Q1,2020-2021
05,2021,Heart disease,7,52082,2021-05-01,2021 Q2,2020-2021
06,2021,Heart disease,8,52090,2021-06-01,2021 Q2,2020-2021
07,2021,Heart disease,7,52097,2021-07-01,2021 Q2,2020-2021
08,2021,Heart disease,5,52102,2021-08-01,2021 Q2,2020-2021
09,2021,Heart disease,2,52104,2021-09-01,2021 Q3,2020-2021
10,2021,Heart disease,1,52105,2021-10-01,2021 Q3,2020-2021
11,2021,Heart disease,1,52106,2021-11-01,2021 Q3,2020-2021
10,2006,Hypertension,1,1,2006-10-01,2006 Q3,2006-2007
10,2007,Hypertension,2,3,2007-10-01,2007 Q3,2006-2007
02,2008,Hypertension,1,4,2008-02-01,2008 Q1,2008-2009
03,2008,Hypertension,1,5,2008-03-01,2008 Q1,2008-2009
04,2008,Hypertension,1,6,2008-04-01,2008 Q1,2008-2009
08,2008,Hypertension,1,7,2008-08-01,2008 Q2,2008-2009
09,2008,Hypertension,2,9,2008-09-01,2008 Q3,2008-2009
11,2008,Hypertension,3,12,2008-11-01,2008 Q3,2008-2009
12,2008,Hypertension,2,14,2008-12-01,2008 Q3,2008-2009
01,2009,Hypertension,309,323,2009-01-01,2009 Q1,2008-2009
02,2009,Hypertension,337,660,2009-02-01,2009 Q1,2008-2009
03,2009,Hypertension,366,1026,2009-03-01,2009 Q1,2008-2009
04,2009,Hypertension,376,1402,2009-04-01,2009 Q1,2008-2009
05,2009,Hypertension,390,1792,2009-05-01,2009 Q2,2008-2009
06,2009,Hypertension,381,2173,2009-06-01,2009 Q2,2008-2009
07,2009,Hypertension,435,2608,2009-07-01,2009 Q2,2008-2009
08,2009,Hypertension,437,3045,2009-08-01,2009 Q2,2008-2009
09,2009,Hypertension,409,3454,2009-09-01,2009 Q3,2008-2009
10,2009,Hypertension,420,3874,2009-10-01,2009 Q3,2008-2009
11,2009,Hypertension,440,4314,2009-11-01,2009 Q3,2008-2009
12,2009,Hypertension,451,4765,2009-12-01,2009 Q3,2008-2009
01,2010,Hypertension,102,4867,2010-01-01,2010 Q1,2010-2011
02,2010,Hypertension,71,4938,2010-02-01,2010 Q1,2010-2011
03,2010,Hypertension,79,5017,2010-03-01,2010 Q1,2010-2011
04,2010,Hypertension,68,5085,2010-04-01,2010 Q1,2010-2011
05,2010,Hypertension,79,5164,2010-05-01,2010 Q2,2010-2011
06,2010,Hypertension,66,5230,2010-06-01,2010 Q2,2010-2011
07,2010,Hypertension,70,5300,2010-07-01,2010 Q2,2010-2011
08,2010,Hypertension,71,5371,2010-08-01,2010 Q2,2010-2011
09,2010,Hypertension,67,5438,2010-09-01,2010 Q3,2010-2011
10,2010,Hypertension,51,5489,2010-10-01,2010 Q3,2010-2011
11,2010,Hypertension,60,5549,2010-11-01,2010 Q3,2010-2011
12,2010,Hypertension,53,5602,2010-12-01,2010 Q3,2010-2011
01,2011,Hypertension,61,5663,2011-01-01,2011 Q1,2010-2011
02,2011,Hypertension,47,5710,2011-02-01,2011 Q1,2010-2011
03,2011,Hypertension,56,5766,2011-03-01,2011 Q1,2010-2011
04,2011,Hypertension,36,5802,2011-04-01,2011 Q1,2010-2011
05,2011,Hypertension,51,5853,2011-05-01,2011 Q2,2010-2011
06,2011,Hypertension,45,5898,2011-06-01,2011 Q2,2010-2011
07,2011,Hypertension,35,5933,2011-07-01,2011 Q2,2010-2011
08,2011,Hypertension,36,5969,2011-08-01,2011 Q2,2010-2011
09,2011,Hypertension,39,6008,2011-09-01,2011 Q3,2010-2011
10,2011,Hypertension,42,6050,2011-10-01,2011 Q3,2010-2011
11,2011,Hypertension,43,6093,2011-11-01,2011 Q3,2010-2011
12,2011,Hypertension,35,6128,2011-12-01,2011 Q3,2010-2011
01,2012,Hypertension,275,6403,2012-01-01,2012 Q1,2012-2013
02,2012,Hypertension,262,6665,2012-02-01,2012 Q1,2012-2013
03,2012,Hypertension,260,6925,2012-03-01,2012 Q1,2012-2013
04,2012,Hypertension,284,7209,2012-04-01,2012 Q1,2012-2013
05,2012,Hypertension,279,7488,2012-05-01,2012 Q2,2012-2013
06,2012,Hypertension,286,7774,2012-06-01,2012 Q2,2012-2013
07,2012,Hypertension,303,8077,2012-07-01,2012 Q2,2012-2013
08,2012,Hypertension,304,8381,2012-08-01,2012 Q2,2012-2013
09,2012,Hypertension,330,8711,2012-09-01,2012 Q3,2012-2013
10,2012,Hypertension,298,9009,2012-10-01,2012 Q3,2012-2013
11,2012,Hypertension,291,9300,2012-11-01,2012 Q3,2012-2013
12,2012,Hypertension,327,9627,2012-12-01,2012 Q3,2012-2013
01,2013,Hypertension,70,9697,2013-01-01,2013 Q1,2012-2013
02,2013,Hypertension,70,9767,2013-02-01,2013 Q1,2012-2013
03,2013,Hypertension,62,9829,2013-03-01,2013 Q1,2012-2013
04,2013,Hypertension,64,9893,2013-04-01,2013 Q1,2012-2013
05,2013,Hypertension,52,9945,2013-05-01,2013 Q2,2012-2013
06,2013,Hypertension,62,10007,2013-06-01,2013 Q2,2012-2013
07,2013,Hypertension,58,10065,2013-07-01,2013 Q2,2012-2013
08,2013,Hypertension,53,10118,2013-08-01,2013 Q2,2012-2013
09,2013,Hypertension,57,10175,2013-09-01,2013 Q3,2012-2013
10,2013,Hypertension,61,10236,2013-10-01,2013 Q3,2012-2013
11,2013,Hypertension,57,10293,2013-11-01,2013 Q3,2012-2013
12,2013,Hypertension,56,10349,2013-12-01,2013 Q3,2012-2013
01,2014,Hypertension,46,10395,2014-01-01,2014 Q1,2014-2015
02,2014,Hypertension,52,10447,2014-02-01,2014 Q1,2014-2015
03,2014,Hypertension,61,10508,2014-03-01,2014 Q1,2014-2015
04,2014,Hypertension,52,10560,2014-04-01,2014 Q1,2014-2015
05,2014,Hypertension,58,10618,2014-05-01,2014 Q2,2014-2015
06,2014,Hypertension,52,10670,2014-06-01,2014 Q2,2014-2015
07,2014,Hypertension,53,10723,2014-07-01,2014 Q2,2014-2015
08,2014,Hypertension,51,10774,2014-08-01,2014 Q2,2014-2015
09,2014,Hypertension,56,10830,2014-09-01,2014 Q3,2014-2015
10,2014,Hypertension,62,10892,2014-10-01,2014 Q3,2014-2015
11,2014,Hypertension,49,10941,2014-11-01,2014 Q3,2014-2015
12,2014,Hypertension,43,10984,2014-12-01,2014 Q3,2014-2015
01,2015,Hypertension,312,11296,2015-01-01,2015 Q1,2014-2015
02,2015,Hypertension,283,11579,2015-02-01,2015 Q1,2014-2015
03,2015,Hypertension,316,11895,2015-03-01,2015 Q1,2014-2015
04,2015,Hypertension,330,12225,2015-04-01,2015 Q1,2014-2015
05,2015,Hypertension,347,12572,2015-05-01,2015 Q2,2014-2015
06,2015,Hypertension,322,12894,2015-06-01,2015 Q2,2014-2015
07,2015,Hypertension,345,13239,2015-07-01,2015 Q2,2014-2015
08,2015,Hypertension,335,13574,2015-08-01,2015 Q2,2014-2015
09,2015,Hypertension,353,13927,2015-09-01,2015 Q3,2014-2015
10,2015,Hypertension,331,14258,2015-10-01,2015 Q3,2014-2015
11,2015,Hypertension,360,14618,2015-11-01,2015 Q3,2014-2015
12,2015,Hypertension,362,14980,2015-12-01,2015 Q3,2014-2015
01,2016,Hypertension,101,15081,2016-01-01,2016 Q1,2016-2017
02,2016,Hypertension,92,15173,2016-02-01,2016 Q1,2016-2017
03,2016,Hypertension,101,15274,2016-03-01,2016 Q1,2016-2017
04,2016,Hypertension,106,15380,2016-04-01,2016 Q1,2016-2017
05,2016,Hypertension,108,15488,2016-05-01,2016 Q2,2016-2017
06,2016,Hypertension,121,15609,2016-06-01,2016 Q2,2016-2017
07,2016,Hypertension,93,15702,2016-07-01,2016 Q2,2016-2017
08,2016,Hypertension,120,15822,2016-08-01,2016 Q2,2016-2017
09,2016,Hypertension,104,15926,2016-09-01,2016 Q3,2016-2017
10,2016,Hypertension,125,16051,2016-10-01,2016 Q3,2016-2017
11,2016,Hypertension,104,16155,2016-11-01,2016 Q3,2016-2017
12,2016,Hypertension,103,16258,2016-12-01,2016 Q3,2016-2017
01,2017,Hypertension,99,16357,2017-01-01,2017 Q1,2016-2017
02,2017,Hypertension,100,16457,2017-02-01,2017 Q1,2016-2017
03,2017,Hypertension,117,16574,2017-03-01,2017 Q1,2016-2017
04,2017,Hypertension,111,16685,2017-04-01,2017 Q1,2016-2017
05,2017,Hypertension,88,16773,2017-05-01,2017 Q2,2016-2017
06,2017,Hypertension,96,16869,2017-06-01,2017 Q2,2016-2017
07,2017,Hypertension,114,16983,2017-07-01,2017 Q2,2016-2017
08,2017,Hypertension,110,17093,2017-08-01,2017 Q2,2016-2017
09,2017,Hypertension,100,17193,2017-09-01,2017 Q3,2016-2017
10,2017,Hypertension,110,17303,2017-10-01,2017 Q3,2016-2017
11,2017,Hypertension,114,17417,2017-11-01,2017 Q3,2016-2017
12,2017,Hypertension,114,17531,2017-12-01,2017 Q3,2016-2017
01,2018,Hypertension,555,18086,2018-01-01,2018 Q1,2018-2019
02,2018,Hypertension,494,18580,2018-02-01,2018 Q1,2018-2019
03,2018,Hypertension,528,19108,2018-03-01,2018 Q1,2018-2019
04,2018,Hypertension,557,19665,2018-04-01,2018 Q1,2018-2019
05,2018,Hypertension,588,20253,2018-05-01,2018 Q2,2018-2019
06,2018,Hypertension,536,20789,2018-06-01,2018 Q2,2018-2019
07,2018,Hypertension,539,21328,2018-07-01,2018 Q2,2018-2019
08,2018,Hypertension,554,21882,2018-08-01,2018 Q2,2018-2019
09,2018,Hypertension,543,22425,2018-09-01,2018 Q3,2018-2019
10,2018,Hypertension,528,22953,2018-10-01,2018 Q3,2018-2019
11,2018,Hypertension,541,23494,2018-11-01,2018 Q3,2018-2019
12,2018,Hypertension,553,24047,2018-12-01,2018 Q3,2018-2019
01,2019,Hypertension,136,24183,2019-01-01,2019 Q1,2018-2019
02,2019,Hypertension,117,24300,2019-02-01,2019 Q1,2018-2019
03,2019,Hypertension,116,24416,2019-03-01,2019 Q1,2018-2019
04,2019,Hypertension,90,24506,2019-04-01,2019 Q1,2018-2019
05,2019,Hypertension,100,24606,2019-05-01,2019 Q2,2018-2019
06,2019,Hypertension,92,24698,2019-06-01,2019 Q2,2018-2019
07,2019,Hypertension,88,24786,2019-07-01,2019 Q2,2018-2019
08,2019,Hypertension,89,24875,2019-08-01,2019 Q2,2018-2019
09,2019,Hypertension,78,24953,2019-09-01,2019 Q3,2018-2019
10,2019,Hypertension,89,25042,2019-10-01,2019 Q3,2018-2019
11,2019,Hypertension,57,25099,2019-11-01,2019 Q3,2018-2019
12,2019,Hypertension,68,25167,2019-12-01,2019 Q3,2018-2019
01,2020,Hypertension,68,25235,2020-01-01,2020 Q1,2020-2021
02,2020,Hypertension,59,25294,2020-02-01,2020 Q1,2020-2021
03,2020,Hypertension,54,25348,2020-03-01,2020 Q1,2020-2021
04,2020,Hypertension,61,25409,2020-04-01,2020 Q1,2020-2021
05,2020,Hypertension,43,25452,2020-05-01,2020 Q2,2020-2021
06,2020,Hypertension,49,25501,2020-06-01,2020 Q2,2020-2021
07,2020,Hypertension,46,25547,2020-07-01,2020 Q2,2020-2021
08,2020,Hypertension,31,25578,2020-08-01,2020 Q2,2020-2021
09,2020,Hypertension,28,25606,2020-09-01,2020 Q3,2020-2021
10,2020,Hypertension,34,25640,2020-10-01,2020 Q3,2020-2021
11,2020,Hypertension,31,25671,2020-11-01,2020 Q3,2020-2021
12,2020,Hypertension,27,25698,2020-12-01,2020 Q3,2020-2021
01,2021,Hypertension,28,25726,2021-01-01,2021 Q1,2020-2021
02,2021,Hypertension,19,25745,2021-02-01,2021 Q1,2020-2021
03,2021,Hypertension,14,25759,2021-03-01,2021 Q1,2020-2021
04,2021,Hypertension,12,25771,2021-04-01,2021 Q1,2020-2021
05,2021,Hypertension,3,25774,2021-05-01,2021 Q2,2020-2021
06,2021,Hypertension,9,25783,2021-06-01,2021 Q2,2020-2021
07,2021,Hypertension,9,25792,2021-07-01,2021 Q2,2020-2021
08,2021,Hypertension,7,25799,2021-08-01,2021 Q2,2020-2021
09,2021,Hypertension,2,25801,2021-09-01,2021 Q3,2020-2021
10,2021,Hypertension,1,25802,2021-10-01,2021 Q3,2020-2021
11,2006,Nash,1,1,2006-11-01,2006 Q3,2006-2007
02,2008,Nash,1,2,2008-02-01,2008 Q1,2008-2009
12,2008,Nash,2,4,2008-12-01,2008 Q3,2008-2009
01,2009,Nash,85,89,2009-01-01,2009 Q1,2008-2009
02,2009,Nash,70,159,2009-02-01,2009 Q1,2008-2009
03,2009,Nash,101,260,2009-03-01,2009 Q1,2008-2009
04,2009,Nash,120,380,2009-04-01,2009 Q1,2008-2009
05,2009,Nash,94,474,2009-05-01,2009 Q2,2008-2009
06,2009,Nash,124,598,2009-06-01,2009 Q2,2008-2009
07,2009,Nash,107,705,2009-07-01,2009 Q2,2008-2009
08,2009,Nash,114,819,2009-08-01,2009 Q2,2008-2009
09,2009,Nash,103,922,2009-09-01,2009 Q3,2008-2009
10,2009,Nash,92,1014,2009-10-01,2009 Q3,2008-2009
11,2009,Nash,114,1128,2009-11-01,2009 Q3,2008-2009
12,2009,Nash,96,1224,2009-12-01,2009 Q3,2008-2009
01,2010,Nash,40,1264,2010-01-01,2010 Q1,2010-2011
02,2010,Nash,47,1311,2010-02-01,2010 Q1,2010-2011
03,2010,Nash,20,1331,2010-03-01,2010 Q1,2010-2011
04,2010,Nash,25,1356,2010-04-01,2010 Q1,2010-2011
05,2010,Nash,23,1379,2010-05-01,2010 Q2,2010-2011
06,2010,Nash,30,1409,2010-06-01,2010 Q2,2010-2011
07,2010,Nash,22,1431,2010-07-01,2010 Q2,2010-2011
08,2010,Nash,21,1452,2010-08-01,2010 Q2,2010-2011
09,2010,Nash,15,1467,2010-09-01,2010 Q3,2010-2011
10,2010,Nash,19,1486,2010-10-01,2010 Q3,2010-2011
11,2010,Nash,16,1502,2010-11-01,2010 Q3,2010-2011
12,2010,Nash,19,1521,2010-12-01,2010 Q3,2010-2011
01,2011,Nash,20,1541,2011-01-01,2011 Q1,2010-2011
02,2011,Nash,10,1551,2011-02-01,2011 Q1,2010-2011
03,2011,Nash,25,1576,2011-03-01,2011 Q1,2010-2011
04,2011,Nash,21,1597,2011-04-01,2011 Q1,2010-2011
05,2011,Nash,15,1612,2011-05-01,2011 Q2,2010-2011
06,2011,Nash,24,1636,2011-06-01,2011 Q2,2010-2011
07,2011,Nash,12,1648,2011-07-01,2011 Q2,2010-2011
08,2011,Nash,16,1664,2011-08-01,2011 Q2,2010-2011
09,2011,Nash,14,1678,2011-09-01,2011 Q3,2010-2011
10,2011,Nash,12,1690,2011-10-01,2011 Q3,2010-2011
11,2011,Nash,15,1705,2011-11-01,2011 Q3,2010-2011
12,2011,Nash,18,1723,2011-12-01,2011 Q3,2010-2011
01,2012,Nash,118,1841,2012-01-01,2012 Q1,2012-2013
02,2012,Nash,78,1919,2012-02-01,2012 Q1,2012-2013
03,2012,Nash,108,2027,2012-03-01,2012 Q1,2012-2013
04,2012,Nash,100,2127,2012-04-01,2012 Q1,2012-2013
05,2012,Nash,97,2224,2012-05-01,2012 Q2,2012-2013
06,2012,Nash,109,2333,2012-06-01,2012 Q2,2012-2013
07,2012,Nash,119,2452,2012-07-01,2012 Q2,2012-2013
08,2012,Nash,117,2569,2012-08-01,2012 Q2,2012-2013
09,2012,Nash,130,2699,2012-09-01,2012 Q3,2012-2013
10,2012,Nash,122,2821,2012-10-01,2012 Q3,2012-2013
11,2012,Nash,115,2936,2012-11-01,2012 Q3,2012-2013
12,2012,Nash,132,3068,2012-12-01,2012 Q3,2012-2013
01,2013,Nash,35,3103,2013-01-01,2013 Q1,2012-2013
02,2013,Nash,35,3138,2013-02-01,2013 Q1,2012-2013
03,2013,Nash,30,3168,2013-03-01,2013 Q1,2012-2013
04,2013,Nash,35,3203,2013-04-01,2013 Q1,2012-2013
05,2013,Nash,26,3229,2013-05-01,2013 Q2,2012-2013
06,2013,Nash,19,3248,2013-06-01,2013 Q2,2012-2013
07,2013,Nash,29,3277,2013-07-01,2013 Q2,2012-2013
08,2013,Nash,25,3302,2013-08-01,2013 Q2,2012-2013
09,2013,Nash,33,3335,2013-09-01,2013 Q3,2012-2013
10,2013,Nash,20,3355,2013-10-01,2013 Q3,2012-2013
11,2013,Nash,18,3373,2013-11-01,2013 Q3,2012-2013
12,2013,Nash,23,3396,2013-12-01,2013 Q3,2012-2013
01,2014,Nash,21,3417,2014-01-01,2014 Q1,2014-2015
02,2014,Nash,22,3439,2014-02-01,2014 Q1,2014-2015
03,2014,Nash,22,3461,2014-03-01,2014 Q1,2014-2015
04,2014,Nash,26,3487,2014-04-01,2014 Q1,2014-2015
05,2014,Nash,27,3514,2014-05-01,2014 Q2,2014-2015
06,2014,Nash,24,3538,2014-06-01,2014 Q2,2014-2015
07,2014,Nash,20,3558,2014-07-01,2014 Q2,2014-2015
08,2014,Nash,19,3577,2014-08-01,2014 Q2,2014-2015
09,2014,Nash,20,3597,2014-09-01,2014 Q3,2014-2015
10,2014,Nash,23,3620,2014-10-01,2014 Q3,2014-2015
11,2014,Nash,22,3642,2014-11-01,2014 Q3,2014-2015
12,2014,Nash,19,3661,2014-12-01,2014 Q3,2014-2015
01,2015,Nash,119,3780,2015-01-01,2015 Q1,2014-2015
02,2015,Nash,112,3892,2015-02-01,2015 Q1,2014-2015
03,2015,Nash,124,4016,2015-03-01,2015 Q1,2014-2015
04,2015,Nash,147,4163,2015-04-01,2015 Q1,2014-2015
05,2015,Nash,148,4311,2015-05-01,2015 Q2,2014-2015
06,2015,Nash,162,4473,2015-06-01,2015 Q2,2014-2015
07,2015,Nash,173,4646,2015-07-01,2015 Q2,2014-2015
08,2015,Nash,157,4803,2015-08-01,2015 Q2,2014-2015
09,2015,Nash,145,4948,2015-09-01,2015 Q3,2014-2015
10,2015,Nash,149,5097,2015-10-01,2015 Q3,2014-2015
11,2015,Nash,169,5266,2015-11-01,2015 Q3,2014-2015
12,2015,Nash,157,5423,2015-12-01,2015 Q3,2014-2015
01,2016,Nash,46,5469,2016-01-01,2016 Q1,2016-2017
02,2016,Nash,53,5522,2016-02-01,2016 Q1,2016-2017
03,2016,Nash,48,5570,2016-03-01,2016 Q1,2016-2017
04,2016,Nash,43,5613,2016-04-01,2016 Q1,2016-2017
05,2016,Nash,44,5657,2016-05-01,2016 Q2,2016-2017
06,2016,Nash,39,5696,2016-06-01,2016 Q2,2016-2017
07,2016,Nash,31,5727,2016-07-01,2016 Q2,2016-2017
08,2016,Nash,44,5771,2016-08-01,2016 Q2,2016-2017
09,2016,Nash,31,5802,2016-09-01,2016 Q3,2016-2017
10,2016,Nash,35,5837,2016-10-01,2016 Q3,2016-2017
11,2016,Nash,43,5880,2016-11-01,2016 Q3,2016-2017
12,2016,Nash,29,5909,2016-12-01,2016 Q3,2016-2017
01,2017,Nash,26,5935,2017-01-01,2017 Q1,2016-2017
02,2017,Nash,33,5968,2017-02-01,2017 Q1,2016-2017
03,2017,Nash,32,6000,2017-03-01,2017 Q1,2016-2017
04,2017,Nash,36,6036,2017-04-01,2017 Q1,2016-2017
05,2017,Nash,33,6069,2017-05-01,2017 Q2,2016-2017
06,2017,Nash,36,6105,2017-06-01,2017 Q2,2016-2017
07,2017,Nash,30,6135,2017-07-01,2017 Q2,2016-2017
08,2017,Nash,45,6180,2017-08-01,2017 Q2,2016-2017
09,2017,Nash,39,6219,2017-09-01,2017 Q3,2016-2017
10,2017,Nash,33,6252,2017-10-01,2017 Q3,2016-2017
11,2017,Nash,29,6281,2017-11-01,2017 Q3,2016-2017
12,2017,Nash,33,6314,2017-12-01,2017 Q3,2016-2017
01,2018,Nash,140,6454,2018-01-01,2018 Q1,2018-2019
02,2018,Nash,130,6584,2018-02-01,2018 Q1,2018-2019
03,2018,Nash,153,6737,2018-03-01,2018 Q1,2018-2019
04,2018,Nash,163,6900,2018-04-01,2018 Q1,2018-2019
05,2018,Nash,174,7074,2018-05-01,2018 Q2,2018-2019
06,2018,Nash,168,7242,2018-06-01,2018 Q2,2018-2019
07,2018,Nash,170,7412,2018-07-01,2018 Q2,2018-2019
08,2018,Nash,173,7585,2018-08-01,2018 Q2,2018-2019
09,2018,Nash,166,7751,2018-09-01,2018 Q3,2018-2019
10,2018,Nash,191,7942,2018-10-01,2018 Q3,2018-2019
11,2018,Nash,161,8103,2018-11-01,2018 Q3,2018-2019
12,2018,Nash,181,8284,2018-12-01,2018 Q3,2018-2019
01,2019,Nash,53,8337,2019-01-01,2019 Q1,2018-2019
02,2019,Nash,37,8374,2019-02-01,2019 Q1,2018-2019
03,2019,Nash,45,8419,2019-03-01,2019 Q1,2018-2019
04,2019,Nash,34,8453,2019-04-01,2019 Q1,2018-2019
05,2019,Nash,35,8488,2019-05-01,2019 Q2,2018-2019
06,2019,Nash,30,8518,2019-06-01,2019 Q2,2018-2019
07,2019,Nash,29,8547,2019-07-01,2019 Q2,2018-2019
08,2019,Nash,30,8577,2019-08-01,2019 Q2,2018-2019
09,2019,Nash,33,8610,2019-09-01,2019 Q3,2018-2019
10,2019,Nash,26,8636,2019-10-01,2019 Q3,2018-2019
11,2019,Nash,20,8656,2019-11-01,2019 Q3,2018-2019
12,2019,Nash,27,8683,2019-12-01,2019 Q3,2018-2019
01,2020,Nash,25,8708,2020-01-01,2020 Q1,2020-2021
02,2020,Nash,20,8728,2020-02-01,2020 Q1,2020-2021
03,2020,Nash,11,8739,2020-03-01,2020 Q1,2020-2021
04,2020,Nash,16,8755,2020-04-01,2020 Q1,2020-2021
05,2020,Nash,24,8779,2020-05-01,2020 Q2,2020-2021
06,2020,Nash,10,8789,2020-06-01,2020 Q2,2020-2021
07,2020,Nash,11,8800,2020-07-01,2020 Q2,2020-2021
08,2020,Nash,21,8821,2020-08-01,2020 Q2,2020-2021
09,2020,Nash,9,8830,2020-09-01,2020 Q3,2020-2021
10,2020,Nash,7,8837,2020-10-01,2020 Q3,2020-2021
11,2020,Nash,9,8846,2020-11-01,2020 Q3,2020-2021
12,2020,Nash,9,8855,2020-12-01,2020 Q3,2020-2021
01,2021,Nash,8,8863,2021-01-01,2021 Q1,2020-2021
02,2021,Nash,5,8868,2021-02-01,2021 Q1,2020-2021
03,2021,Nash,4,8872,2021-03-01,2021 Q1,2020-2021
04,2021,Nash,6,8878,2021-04-01,2021 Q1,2020-2021
05,2021,Nash,5,8883,2021-05-01,2021 Q2,2020-2021
06,2021,Nash,4,8887,2021-06-01,2021 Q2,2020-2021
07,2021,Nash,2,8889,2021-07-01,2021 Q2,2020-2021
08,2021,Nash,2,8891,2021-08-01,2021 Q2,2020-2021
10,2021,Nash,1,8892,2021-10-01,2021 Q3,2020-2021
11,2021,Nash,2,8894,2021-11-01,2021 Q3,2020-2021
11,2006,Obesity,1,1,2006-11-01,2006 Q3,2006-2007
09,2007,Obesity,1,2,2007-09-01,2007 Q3,2006-2007
04,2008,Obesity,2,4,2008-04-01,2008 Q1,2008-2009
09,2008,Obesity,1,5,2008-09-01,2008 Q3,2008-2009
01,2009,Obesity,200,205,2009-01-01,2009 Q1,2008-2009
02,2009,Obesity,187,392,2009-02-01,2009 Q1,2008-2009
03,2009,Obesity,254,646,2009-03-01,2009 Q1,2008-2009
04,2009,Obesity,234,880,2009-04-01,2009 Q1,2008-2009
05,2009,Obesity,235,1115,2009-05-01,2009 Q2,2008-2009
06,2009,Obesity,230,1345,2009-06-01,2009 Q2,2008-2009
07,2009,Obesity,245,1590,2009-07-01,2009 Q2,2008-2009
08,2009,Obesity,234,1824,2009-08-01,2009 Q2,2008-2009
09,2009,Obesity,225,2049,2009-09-01,2009 Q3,2008-2009
10,2009,Obesity,244,2293,2009-10-01,2009 Q3,2008-2009
11,2009,Obesity,256,2549,2009-11-01,2009 Q3,2008-2009
12,2009,Obesity,232,2781,2009-12-01,2009 Q3,2008-2009
01,2010,Obesity,66,2847,2010-01-01,2010 Q1,2010-2011
02,2010,Obesity,54,2901,2010-02-01,2010 Q1,2010-2011
03,2010,Obesity,43,2944,2010-03-01,2010 Q1,2010-2011
04,2010,Obesity,46,2990,2010-04-01,2010 Q1,2010-2011
05,2010,Obesity,43,3033,2010-05-01,2010 Q2,2010-2011
06,2010,Obesity,53,3086,2010-06-01,2010 Q2,2010-2011
07,2010,Obesity,42,3128,2010-07-01,2010 Q2,2010-2011
08,2010,Obesity,39,3167,2010-08-01,2010 Q2,2010-2011
09,2010,Obesity,39,3206,2010-09-01,2010 Q3,2010-2011
10,2010,Obesity,47,3253,2010-10-01,2010 Q3,2010-2011
11,2010,Obesity,46,3299,2010-11-01,2010 Q3,2010-2011
12,2010,Obesity,40,3339,2010-12-01,2010 Q3,2010-2011
01,2011,Obesity,43,3382,2011-01-01,2011 Q1,2010-2011
02,2011,Obesity,30,3412,2011-02-01,2011 Q1,2010-2011
03,2011,Obesity,48,3460,2011-03-01,2011 Q1,2010-2011
04,2011,Obesity,34,3494,2011-04-01,2011 Q1,2010-2011
05,2011,Obesity,41,3535,2011-05-01,2011 Q2,2010-2011
06,2011,Obesity,34,3569,2011-06-01,2011 Q2,2010-2011
07,2011,Obesity,34,3603,2011-07-01,2011 Q2,2010-2011
08,2011,Obesity,37,3640,2011-08-01,2011 Q2,2010-2011
09,2011,Obesity,38,3678,2011-09-01,2011 Q3,2010-2011
10,2011,Obesity,32,3710,2011-10-01,2011 Q3,2010-2011
11,2011,Obesity,36,3746,2011-11-01,2011 Q3,2010-2011
12,2011,Obesity,40,3786,2011-12-01,2011 Q3,2010-2011
01,2012,Obesity,263,4049,2012-01-01,2012 Q1,2012-2013
02,2012,Obesity,248,4297,2012-02-01,2012 Q1,2012-2013
03,2012,Obesity,267,4564,2012-03-01,2012 Q1,2012-2013
04,2012,Obesity,268,4832,2012-04-01,2012 Q1,2012-2013
05,2012,Obesity,294,5126,2012-05-01,2012 Q2,2012-2013
06,2012,Obesity,247,5373,2012-06-01,2012 Q2,2012-2013
07,2012,Obesity,267,5640,2012-07-01,2012 Q2,2012-2013
08,2012,Obesity,339,5979,2012-08-01,2012 Q2,2012-2013
09,2012,Obesity,277,6256,2012-09-01,2012 Q3,2012-2013
10,2012,Obesity,237,6493,2012-10-01,2012 Q3,2012-2013
11,2012,Obesity,292,6785,2012-11-01,2012 Q3,2012-2013
12,2012,Obesity,283,7068,2012-12-01,2012 Q3,2012-2013
01,2013,Obesity,87,7155,2013-01-01,2013 Q1,2012-2013
02,2013,Obesity,67,7222,2013-02-01,2013 Q1,2012-2013
03,2013,Obesity,72,7294,2013-03-01,2013 Q1,2012-2013
04,2013,Obesity,65,7359,2013-04-01,2013 Q1,2012-2013
05,2013,Obesity,71,7430,2013-05-01,2013 Q2,2012-2013
06,2013,Obesity,71,7501,2013-06-01,2013 Q2,2012-2013
07,2013,Obesity,59,7560,2013-07-01,2013 Q2,2012-2013
08,2013,Obesity,59,7619,2013-08-01,2013 Q2,2012-2013
09,2013,Obesity,78,7697,2013-09-01,2013 Q3,2012-2013
10,2013,Obesity,54,7751,2013-10-01,2013 Q3,2012-2013
11,2013,Obesity,72,7823,2013-11-01,2013 Q3,2012-2013
12,2013,Obesity,69,7892,2013-12-01,2013 Q3,2012-2013
01,2014,Obesity,51,7943,2014-01-01,2014 Q1,2014-2015
02,2014,Obesity,55,7998,2014-02-01,2014 Q1,2014-2015
03,2014,Obesity,64,8062,2014-03-01,2014 Q1,2014-2015
04,2014,Obesity,58,8120,2014-04-01,2014 Q1,2014-2015
05,2014,Obesity,48,8168,2014-05-01,2014 Q2,2014-2015
06,2014,Obesity,58,8226,2014-06-01,2014 Q2,2014-2015
07,2014,Obesity,86,8312,2014-07-01,2014 Q2,2014-2015
08,2014,Obesity,68,8380,2014-08-01,2014 Q2,2014-2015
09,2014,Obesity,50,8430,2014-09-01,2014 Q3,2014-2015
10,2014,Obesity,59,8489,2014-10-01,2014 Q3,2014-2015
11,2014,Obesity,57,8546,2014-11-01,2014 Q3,2014-2015
12,2014,Obesity,57,8603,2014-12-01,2014 Q3,2014-2015
01,2015,Obesity,366,8969,2015-01-01,2015 Q1,2014-2015
02,2015,Obesity,360,9329,2015-02-01,2015 Q1,2014-2015
03,2015,Obesity,393,9722,2015-03-01,2015 Q1,2014-2015
04,2015,Obesity,419,10141,2015-04-01,2015 Q1,2014-2015
05,2015,Obesity,405,10546,2015-05-01,2015 Q2,2014-2015
06,2015,Obesity,375,10921,2015-06-01,2015 Q2,2014-2015
07,2015,Obesity,397,11318,2015-07-01,2015 Q2,2014-2015
08,2015,Obesity,421,11739,2015-08-01,2015 Q2,2014-2015
09,2015,Obesity,392,12131,2015-09-01,2015 Q3,2014-2015
10,2015,Obesity,400,12531,2015-10-01,2015 Q3,2014-2015
11,2015,Obesity,452,12983,2015-11-01,2015 Q3,2014-2015
12,2015,Obesity,412,13395,2015-12-01,2015 Q3,2014-2015
01,2016,Obesity,116,13511,2016-01-01,2016 Q1,2016-2017
02,2016,Obesity,116,13627,2016-02-01,2016 Q1,2016-2017
03,2016,Obesity,125,13752,2016-03-01,2016 Q1,2016-2017
04,2016,Obesity,103,13855,2016-04-01,2016 Q1,2016-2017
05,2016,Obesity,107,13962,2016-05-01,2016 Q2,2016-2017
06,2016,Obesity,81,14043,2016-06-01,2016 Q2,2016-2017
07,2016,Obesity,97,14140,2016-07-01,2016 Q2,2016-2017
08,2016,Obesity,109,14249,2016-08-01,2016 Q2,2016-2017
09,2016,Obesity,94,14343,2016-09-01,2016 Q3,2016-2017
10,2016,Obesity,83,14426,2016-10-01,2016 Q3,2016-2017
11,2016,Obesity,67,14493,2016-11-01,2016 Q3,2016-2017
12,2016,Obesity,98,14591,2016-12-01,2016 Q3,2016-2017
01,2017,Obesity,77,14668,2017-01-01,2017 Q1,2016-2017
02,2017,Obesity,60,14728,2017-02-01,2017 Q1,2016-2017
03,2017,Obesity,89,14817,2017-03-01,2017 Q1,2016-2017
04,2017,Obesity,59,14876,2017-04-01,2017 Q1,2016-2017
05,2017,Obesity,77,14953,2017-05-01,2017 Q2,2016-2017
06,2017,Obesity,72,15025,2017-06-01,2017 Q2,2016-2017
07,2017,Obesity,77,15102,2017-07-01,2017 Q2,2016-2017
08,2017,Obesity,64,15166,2017-08-01,2017 Q2,2016-2017
09,2017,Obesity,75,15241,2017-09-01,2017 Q3,2016-2017
10,2017,Obesity,58,15299,2017-10-01,2017 Q3,2016-2017
11,2017,Obesity,67,15366,2017-11-01,2017 Q3,2016-2017
12,2017,Obesity,70,15436,2017-12-01,2017 Q3,2016-2017
01,2018,Obesity,370,15806,2018-01-01,2018 Q1,2018-2019
02,2018,Obesity,324,16130,2018-02-01,2018 Q1,2018-2019
03,2018,Obesity,371,16501,2018-03-01,2018 Q1,2018-2019
04,2018,Obesity,331,16832,2018-04-01,2018 Q1,2018-2019
05,2018,Obesity,340,17172,2018-05-01,2018 Q2,2018-2019
06,2018,Obesity,343,17515,2018-06-01,2018 Q2,2018-2019
07,2018,Obesity,319,17834,2018-07-01,2018 Q2,2018-2019
08,2018,Obesity,363,18197,2018-08-01,2018 Q2,2018-2019
09,2018,Obesity,353,18550,2018-09-01,2018 Q3,2018-2019
10,2018,Obesity,355,18905,2018-10-01,2018 Q3,2018-2019
11,2018,Obesity,372,19277,2018-11-01,2018 Q3,2018-2019
12,2018,Obesity,366,19643,2018-12-01,2018 Q3,2018-2019
01,2019,Obesity,96,19739,2019-01-01,2019 Q1,2018-2019
02,2019,Obesity,61,19800,2019-02-01,2019 Q1,2018-2019
03,2019,Obesity,67,19867,2019-03-01,2019 Q1,2018-2019
04,2019,Obesity,62,19929,2019-04-01,2019 Q1,2018-2019
05,2019,Obesity,62,19991,2019-05-01,2019 Q2,2018-2019
06,2019,Obesity,48,20039,2019-06-01,2019 Q2,2018-2019
07,2019,Obesity,64,20103,2019-07-01,2019 Q2,2018-2019
08,2019,Obesity,45,20148,2019-08-01,2019 Q2,2018-2019
09,2019,Obesity,50,20198,2019-09-01,2019 Q3,2018-2019
10,2019,Obesity,49,20247,2019-10-01,2019 Q3,2018-2019
11,2019,Obesity,37,20284,2019-11-01,2019 Q3,2018-2019
12,2019,Obesity,32,20316,2019-12-01,2019 Q3,2018-2019
01,2020,Obesity,49,20365,2020-01-01,2020 Q1,2020-2021
02,2020,Obesity,52,20417,2020-02-01,2020 Q1,2020-2021
03,2020,Obesity,39,20456,2020-03-01,2020 Q1,2020-2021
04,2020,Obesity,27,20483,2020-04-01,2020 Q1,2020-2021
05,2020,Obesity,37,20520,2020-05-01,2020 Q2,2020-2021
06,2020,Obesity,31,20551,2020-06-01,2020 Q2,2020-2021
07,2020,Obesity,26,20577,2020-07-01,2020 Q2,2020-2021
08,2020,Obesity,22,20599,2020-08-01,2020 Q2,2020-2021
09,2020,Obesity,20,20619,2020-09-01,2020 Q3,2020-2021
10,2020,Obesity,16,20635,2020-10-01,2020 Q3,2020-2021
11,2020,Obesity,24,20659,2020-11-01,2020 Q3,2020-2021
12,2020,Obesity,15,20674,2020-12-01,2020 Q3,2020-2021
01,2021,Obesity,14,20688,2021-01-01,2021 Q1,2020-2021
02,2021,Obesity,8,20696,2021-02-01,2021 Q1,2020-2021
03,2021,Obesity,6,20702,2021-03-01,2021 Q1,2020-2021
04,2021,Obesity,8,20710,2021-04-01,2021 Q1,2020-2021
05,2021,Obesity,10,20720,2021-05-01,2021 Q2,2020-2021
06,2021,Obesity,3,20723,2021-06-01,2021 Q2,2020-2021
07,2021,Obesity,3,20726,2021-07-01,2021 Q2,2020-2021
08,2021,Obesity,4,20730,2021-08-01,2021 Q2,2020-2021
10,2021,Obesity,1,20731,2021-10-01,2021 Q3,2020-2021
11,2021,Obesity,1,20732,2021-11-01,2021 Q3,2020-2021
